{
  "tileHeight": 32,
  "tileWidth": 32,
  "width": 10,
  "height": 10,
  "characters": {
    "player": {
      "_load": "assets/maps/shared/player.json",
      "_override": {
        "x": 1,
        "y": 4,
        "direction": 3
      }
    }
  },
  "layers":[
    {
      "_load": "assets/maps/shared/room.json",
      "_override": {
        "name": "Ground",
        "zIndex": 3,
        "layout": [
          40, 40, 40, 40, 40, 40, 40, 40, 40, 40,
          40, 24, 24, 24, 24, 24, 24, 24, 24, 40,
          40, 24, 24, 24, 24, 24, 24, 24, 24, 40,
          40,  1,  1,  1,  1,  1,  1,  1,  1, 40,
          40,  1,  1,  1,  1,  1,  1,  1,  1, 40,
          40,  1,  1,  1,  1,  1,  1,  1,  1, 40,
          40,  1,  1,  1,  1,  1,  1,  1,  1, 40,
          40,  1,  1,  1,  1,  1,  1,  1,  1, 40,
          40,  1,  1,  1,  1,  1,  1,  1,  1, 40,
          40, 40, 40, 40, 40, 40, 40, 40, 40, 40
        ]
      }
    },
    {
      "_load": "assets/maps/shared/room.json",
      "_override": {
        "name": "Objects",
        "zIndex": 5,
        "layout": [
          40, 40, 40, 40, 40, 40, 40, 40, 40, 40,
          40, 40,  7, 40, 18, 19, 40,  7, 40, 40,
          40, 40, 15, 40, 26, 27, 40, 15, 40, 40,
          40, 40, 40, 40, 40, 40, 40, 40, 40, 40,
          40, 40, 40, 28, 12, 40, 28, 40, 40, 40,
          40, 40, 40, 40, 40, 40, 40, 40, 40, 40,
          40, 40, 40, 28, 40, 40, 28, 40, 40, 40,
          40, 40, 40, 40, 40, 40, 40, 40, 40, 40,
          40, 40, 40, 28, 40, 40, 28, 40, 40, 40,
          40, 40, 40, 40, 40, 40, 40, 40, 40, 40
        ]
      }
    },
    {
      "_load": "assets/maps/shared/room.json",
      "_override": {
        "name": "ObjectsForeground",
        "zIndex": 10,
        "layout": [
          40, 40, 40, 40, 40, 40, 40, 40, 40, 40,
          40, 40, 40, 40, 40, 40, 40, 40, 40, 40,
          40, 40, 40, 40, 40, 40, 40, 40, 40, 40,
          40, 40, 40, 20, 40, 40, 20, 40, 40, 40,
          40, 40, 40, 40, 40, 40, 40, 40, 40, 40,
          40, 40, 40, 20, 40, 40, 20, 40, 40, 40,
          40, 40, 40, 40, 40, 40, 40, 40, 40, 40,
          40, 40, 40, 20, 40, 40, 20, 40, 40, 40,
          40, 40, 40, 40, 40, 40, 40, 40, 40, 40,
          40, 40, 40, 40, 40, 40, 40, 40, 40, 40
        ],
        "shadowDistance": {
          "color": "0, 0, 33",
          "distance": 7,
          "darkness": 0.95
        }
      }
    },
    {
      "name": "collision",
      "tileset": 0,
      "visible": false,
      "width": 10,
      "height": 10,
      "x": 0,
      "y": 0,
      "zIndex": 99,
      "layout": [
        40, 40, 40, 40, 40, 40, 40, 40, 40, 40,
        40, 24, 24, 24, 24, 24, 24, 24, 24, 40,
        40, 24, 24, 24, 24, 24, 24, 24, 24, 40,
        40,  0,  0,  0,  0,  0,  0,  0,  0, 40,
        40,  0,  0,  1,  1,  0,  1,  0,  0, 40,
        40,  0,  0,  0,  0,  0,  0,  0,  0, 40,
        40,  0,  0,  1,  0,  0,  1,  0,  0, 40,
        40,  0,  0,  0,  0,  0,  0,  0,  0, 40,
        40,  0,  0,  1,  0,  0,  1,  0,  0, 40,
        40, 40, 40, 40, 40, 40, 40, 40, 40, 40
      ]
    }
  ],
  "tilesets": [
    {
      "_load": "./assets/maps/shared/tileset1.json"
    }
  ],
  "actions": []
}
