{
  "width": 15,
  "height": 15,
  "tileHeight": 32,
  "tileWidth": 32,
  "tilesets": [
    {
      "image": "./tiles.png",
      "tileHeight": 32,
      "tileWidth": 32
    }
  ],
  "characters": {
    "player": {
      "sprites": "player.png",
      "width": 32,
      "height": 32,
      "zIndex": 1,
      "framesPerDirection": 2,
      "useLighting": true
    }
  },
  "layers":[
    {
      "name": "background",
      "tileset": 0,
      "width": 15,
      "height": 15,
      "zIndex": 0,
      "visible": true,
      "layout": [
        1, 1, 1, 3, 1, 3, 1, 1, 1, 1, 1, 1, 1, 1, 1,
        1, 1, 1, 3, 1, 3, 1, 1, 1, 1, 1, 1, 1, 1, 1,
        1, 1, 1, 3, 1, 3, 1, 1, 1, 1, 1, 1, 1, 1, 1,
        1, 1, 1, 3, 1, 3, 1, 1, 1, 1, 1, 1, 1, 1, 1,
        1, 1, 1, 3, 1, 3, 1, 1, 1, 1, 1, 1, 1, 1, 1,
        4, 4, 4, 2, 4, 2, 4, 4, 4, 4, 4, 4, 4, 4, 4,
        1, 1, 1, 3, 1, 3, 1, 1, 1, 1, 1, 1, 1, 1, 1,
        4, 4, 4, 2, 4, 2, 4, 4, 4, 4, 4, 4, 4, 4, 4,
        1, 1, 1, 3, 1, 3, 1, 1, 1, 1, 1, 1, 1, 1, 1,
        1, 1, 1, 3, 1, 3, 1, 1, 1, 1, 1, 1, 1, 1, 1,
        1, 1, 1, 3, 1, 3, 1, 1, 1, 1, 1, 1, 1, 1, 1,
        1, 1, 1, 3, 1, 3, 1, 1, 1, 1, 1, 1, 1, 1, 1,
        1, 1, 1, 3, 1, 3, 1, 1, 1, 1, 1, 1, 1, 1, 1,
        1, 1, 1, 3, 1, 3, 1, 1, 1, 1, 1, 1, 1, 1, 1,
        1, 1, 1, 3, 1, 3, 1, 1, 1, 1, 1, 1, 1, 1, 1
      ],
      "shadowDistance": {
        "color": "0, 0, 0",
        "distance": 3,
        "darkness": 1.4
      }
    }
  ]
}
